 . . . . . . .
 . . . . . . S0
 . . @ . . . X
 . @ . @ . @ @
 . @ . @ . @ .
 . @ . @ . @ @
 . @ . @ . . .